100100111
100000001
100000001
100000001
1000p0001
000000000
111111111